# *DO NOT DIRECTLY EDIT THIS FILE, IT IS AUTOMATICALLY GENERATED AND IT IS BASED ON:*
# https://docs.google.com/spreadsheet/ccc?key=0AmQEO36liL4FdDJLWVNMaVV2UmRKSnpXU09MYkdGbEE
aboutDrawio=À propos de draw.io
accessDenied=Accès refusé
action=Action
actualSize=Taille réelle
add=Ajouter
addedFile=Ajouté(e) {1}
addImages=Ajouter des images
addImageUrl=Ajouter l'URL d'une image
addLayer=Ajouter une couche
addProperty=Ajouter une propriété
address=Adresse
addToExistingDrawing=Ajouter au diagramme existant
addWaypoint=Ajouter un repère
adjustTo=Ajuster à
advanced=Avancé
align=Aligner
alignment=Alignement
allChangesLost=Toutes les modifications seront perdues !
allPages=Toutes les pages
allProjects=Tous les projets
allSpaces=Tous les espaces
allTags=Toutes les étiquettes
anchor=Ancre
android=Android
angle=Angle
arc=Arc
areYouSure=Êtes-vous sûr(e) ?
ensureDataSaved=Veuillez enregistrer vos modifications avant de fermer.
allChangesSaved=Toutes les modifications ont été enregistrées
allChangesSavedInDrive=Toutes les modifications ont été enregistrées dans Drive
allowPopups=Autoriser les pop-ups pour ne pas voir cette boite de dialogue.
allowRelativeUrl=Allow relative URL
alreadyConnected=Nœuds déjà connectés
apply=Appliquer
archiMate21=ArchiMate 2.1
arrange=Organiser
arrow=Flèche
arrows=Flèches
asNew=En tant que nouveau
atlas=Atlas
author=Auteur
authorizationRequired=Autorisation requise
authorizeThisAppIn=Autoriser l'application dans {1}:
authorize=Autoriser
authorizing=Autorisation en cours
automatic=Automatique
autosave=Enregistrement auto
autosize=Taille automatique
attachments=Pièces jointes
aws=AWS
aws3d=AWS 3D
azure=Azure
background=Arrière-plan
backgroundColor=Couleur d'arrière-plan
backgroundImage=Image d'arrière-plan
basic=Basique
blankDrawing=Diagramme vierge
blankDiagram=Diagramme vierge
block=Bloc
blockquote=Bloc de citation
blog=Blogue
bold=Gras
bootstrap=Bootstrap
border=Border
borderColor=Couleur de la bordure
borderWidth=Largeur de la bordure
bottom=En bas
bottomAlign=Aligner en bas
bottomLeft=Aligner en bas à gauche
bottomRight=Aligner en bas à droite
bpmn=BPMN
browser=Navigateur
bulletedList=Liste à puces
business=Entreprise
busy=Opération en cours
cabinets=Placards
cancel=Annuler
center=Centrer
cannotLoad=Erreur lors du chargement. Merci de réessayer plus tard.
cannotLogin=Erreur lors de la connexion. Merci de réessayer plus tard.
cannotOpenFile=Impossible d'ouvrir le fichier
change=Modifier
changeOrientation=Modifier l’orientation
changeUser=Modifier l'utilisateur
changesNotSaved=Les modifcations n'ont pas été enregistrées
chatJoined={1} a rejoint le chat
chatLeft={1} a quitté le chat
chatWindowTitle=Chat
chooseAnOption=Choisir une option
chromeApp=Application Chrome
compressed=Compressé
commitMessage=Message commit
csv=CSV
dark=Dark
draftFound=Un brouillon pour '{1}' a été trouvé. Pour poursuivre, souhaitez-vous l'afficher dans l'éditeur ou l'ignorer ?
dragAndDropNotSupported=Le glisser-déposer n'est pas supporté pour les images. Voulez-vous importer à la place?
dropboxCharsNotAllowed=Les caractères suivants ne sont pas autorisés : \ / : ? * " |
check=Vérifier
circle=Cercle
cisco=Cisco
classic=Classique
clearDefaultStyle=Effacer la mise en forme par défaut
clearWaypoints=Effacer les repères
clipart=Clipart
close=Fermer
collaborator=Collaborateur
collaborators=Collaborateurs
collapse=Réduire
collapseExpand=Réduire-Agrandir
collapse-expand=Cliquer pour réduire/agrandir\nShift+clic pour déplacer les voisins\nAlt+clic pour conserver la taille du groupe
collapsible=Réductible
comic=Comic
comment=Commentaire
commentsNotes=Commentaires/Notes
connect=Connecter
connecting=Connexion en cours
connectWithDrive=Connecter avec Google Drive
connection=Connexion
connectionArrows=Flèches de connexion
connectionPoints=Points de connexion
constrainProportions=Restreindre les proportions
containsValidationErrors=Contient des erreurs de validation
copiedToClipboard=Copié au presse-papier
copy=Copier
copyConnect=Copier à la connexion
copyOf=Copie de {1}
copyOfDrawing=Copie d'un dessin
copySize=Copy Size
copyStyle=Copier le style
create=Créer
createNewDiagram=Créer un nouveau diagramme
createRevision=Créer une révision
createShape=Créer une forme
crop=Rogner
curved=Courbé
custom=Personnalisé
current=Courant
cut=Couper
dashed=Pointillé
decideLater=Décider plus tard
default=Par défaut
delete=Supprimer
deleteColumn=Supprimer la colonne
deleteLibrary401=Permissions insuffisantes pour supprimer cette librairie
deleteLibrary404=La librairie sélectionnée n'a pas éte trouvée
deleteLibrary500=Erreur lors de la supression de la librairie
deleteLibraryConfirm=Vous êtes sur le point de supprimer cette librairie. Êtes-vous sûr(e) de vouloir poursuivre ?
deleteRow=Supprimer la ligne
description=Description
device=Périphérique
diagram=Diagramme
diagramContent=Contenu du diagramme
diagramLocked=Le diagramme a éte verrouillé pour éviter des pertes de données.
diagramLockedBySince=The diagram is locked by {1} since {2} ago
diagramName=Nom du diagramme
diagramIsPublic=Le diagramme est public
diagramIsNotPublic=Le diagramme n'est pas public
diamond=Losange
diamondThin=Losange fin
didYouKnow=Le saviez-vous...
direction=Orientation
discard=Annuler
discardChangesAndReconnect=Annuler les modifications et se reconnecter
googleDriveMissingClickHere=Google Drive introuvable ? Cliquez ici !
discardChanges=Annuler les changements
disconnected=Déconnecté
distribute=Distribuer
done=Termine
dotted=Pointillé
doubleClickOrientation=Double-cliquer pour modifier l’orientation
doubleClickTooltip=Double-cliquer pour insérer du texte
doubleClickChangeProperty=Double-cliquer pour changer le nom de la propriété
download=Télécharger
downloadAs=Télécharger en tant que
clickHereToSave=Cliquer ici pour sauvegarder
draftDiscarded=Brouillon abandonné
draftSaved=Brouillon enregistré
dragElementsHere=Glisser des éléments ici
dragImagesHere=Glisser des images ou des URLs ici
dragUrlsHere=Déposer des URLs ici
draw.io=draw.io
drawing=Diagramme{1}
drawingEmpty=Le diagramme est vide
drawingTooLarge=Le diagramme est trop grand
drawioForWork=Draw.io pour GSuite
dropbox=Dropbox
duplicate=Dupliquer
duplicateIt=Dupliquer {1}
divider=Séparateur
east=Est
edit=Modifier
editData=Modifier les paramètres
editDiagram=Modifier le diagramme
editGeometry=Modifier la géométrie
editImage=Modifier l'image
editImageUrl=Modifier l'URL de l'image
editLink=Modifier le lien
editShape=Modifier la forme
editStyle=Modifier le style
editText=Modifier le texte
editTooltip=Modifier l'info-bulle
glass=Verre
googleImages=Google Images
imageSearch=Recherche d'image
eip=EIP
embed=Intégrer
embedImages=Intégrer les images
mainEmbedNotice=Coller cet élément dans la page
electrical=Électricité
ellipse=Ellipse
embedNotice=Coller cet élément à la fin de la page
enterGroup=Entrer un groupe
enterName=Entrer un nom
enterPropertyName=Entrer le nom de la propriété
enterValue=Saisir une valeur
entityRelation=Relation entre les éléments
error=Erreur
errorDeletingFile=Erreur lors de la suppression du fichier
errorLoadingFile=Erreur lors du chargement du fichier
errorRenamingFile=Erreur lors du renommage du fichier.
errorRenamingFileNotFound=Erreur lors du renommage du fichier. Le fichier est introuvable.
errorRenamingFileForbidden=Erreur lors du renommage du fichier. Droits d'accès insuffisants.
errorSavingDraft=Erreur lors de la sauvegarde du brouillon
errorSavingFile=Erreur lors de la sauvegarde du fichier
errorSavingFileUnknown=Erreur d'autorisation avec les serveurs de Google. Veuillez rafraîchir la page et réessayer.
errorSavingFileForbidden=Erreur lors de l'enregistrement du fichier. Droits d'accès insuffisants.
errorSavingFileNameConflict=Le diagramme n'a pas pu être enregistré. La page actuellement ouverte contient déjà un fichier nommé '{1}'.
errorSavingFileNotFound=Erreur lors de l'enregistrement du fichier. Le fichier est introuvable.
errorSavingFileReadOnlyMode=Could not save diagram while read-only mode is active.
errorSavingFileSessionTimeout=Votre session a été fermée. Veuillez <a target='_blank' href='{1}'>{2}</a> et revenir à cet onglet pour tenter d'enregistrer à nouveau.
errorSendingFeedback=Erreur lors de l'envoi du commentaire.
errorUpdatingPreview=Erreur lors de la mise à jour de l'aperçu.
exit=Quitter
exitGroup=Quitter le groupe
expand=Agrandir
export=Exporter
exporting=Exportation
exportAs=Exporter en tant que
exportOptionsDisabled=Possibilités d'export désactivées
exportOptionsDisabledDetails=Le propriétaire a désactivé les possibilités de téléchargement, d'impression ou de copie pour les commentateurs et observateurs sur ce fichier.
extras=Suppléments
facebook=Facebook
failedToSaveTryReconnect=La sauvegarde a échoué, tentative de reconnexion
featureRequest=Demande de fonctionnalité
feedback=Commentaire
feedbackSent=Commentaire envoyé.
floorplans=Plans de sol
file=Fichier
fileChangedOverwrite=Le fichier a été modifié. Ecraser les changements ?
overwrite=Ecraser
filename=Nom de fichier
fileExists=Le fichier existe déjà
fileNearlyFullSeeFaq=Fichier presque plein, veuillez consulter la FAQ
fileNotFound=Fichier non trouvé
repositoryNotFound=Répertoire non trouvé
fileNotFoundOrDenied=Le fichier est introuvable. Le fichier n'existe pas ou vous n'avez pas le droit d'accès en lecture.
fileNotLoaded=Fichier non chargé
fileNotSaved=Fichier non sauvegardé
fileOpenLocation=Comment voulez-vous ouvrir ce(s) fichier(s)?
fileWillBeSavedInAppFolder={1} sera enregistré dans le dossier de l'application.
fill=Remplir
fillColor=Couleur de remplissage
filterCards=Filter Cards
find=Chercher
fit=Ajuster
fitContainer=Redimensionner le conteneur
fitIntoContainer=Ajuster au conteneur
fitPage=Ajuster à la page
fitPageWidth=Ajuster à la largeur de la page
fitTo=Ajuster à
fitToSheetsAcross=feuilles(s) au-dessus
fitToBy=par
fitToSheetsDown=feuilles(s) en bas
fitTwoPages=Deux pages
fitWindow=Ajuster à la fenêtre
flip=Retourner
flipH=Retourner horizontalement
flipV=Retourner verticalement
flowchart=Diagramme de flux
folder=Dossier
font=Police
fontColor=Couleur de la police
fontFamily=Police
fontSize=Taille de la police
forbidden=Vous n'avez pas le droit d'accéder à ce fichier
format=Format
formatPanel=Panneau de mise en forme
formatted=Mis en forme
formattedText=Texte mis en forme
formatPng=PNG
formatGif=GIF
formatJpg=JPEG
formatPdf=PDF
formatSql=SQL
formatSvg=SVG
formatHtmlEmbedded=HTML
formatSvgEmbedded=SVG (avec XML)
formatVsdx=VSDX
formatVssx=VSSX
formatXmlPlain=XML (Texte normal)
formatXml=XML
forum=Forum d'aide
fromTemplate=Depuis un modèle
fromTemplateUrl=A partir d'une URL de modèle
fromText=A partir d'un texte
fromUrl=A partir d'une URL
fromThisPage=A partir de cette page
fullscreen=Plein écran
gap=Gap
general=Général
github=GitHub
gliffy=Gliffy
global=Global
googleDocs=Google Docs
googleDrive=Google Drive
googleGadget=Google Gadget
googlePlus=Google+
googleSites=Google Sites
gradient=Gradient
gradientColor=Couleur
grid=Grille
gridColor=Grille de couleurs
gridSize=Taille de la grille
group=Grouper
guides=Guides
hateApp=Je déteste draw.io
heading=En-tête
height=Hauteur
help=Aide
helpTranslate=Aidez-nous à traduire cette application
hide=Masquer
hideIt=Masquer {1}
hidden=Masqué
home=Accueil
horizontal=Horizontal
horizontalFlow=Flux horizontal
horizontalTree=Arbre horizontal
howTranslate=Etes-vous satisfait(e) de la traduction dans votre langue ?
html=HTML
htmlText=Texte HTML
id=ID
iframe=IFrame
ignore=Ignorer
image=Image
imageUrl=URL de l'image
images=Images
imagePreviewError=Cette image n'a pas pu être chargée pour l'aperçu. Veuillez vérifier l'URL.
imageTooBig=Image trop grande
imgur=Imgur
import=Importer
importFrom=Importer à partir de
includeCopyOfMyDiagram=Inclure une copie de mon diagramme
increaseIndent=Augmenter l'indentation
decreaseIndent=Diminuer l'indentation
insert=Insérer
insertColumnBefore=Insérer une colonne à gauche
insertColumnAfter=Insérer une colonne à droite
insertEllipse=Insérer une ellipse
insertImage=Insérer une image
insertHorizontalRule=Insérer une règle horizontale
insertLink=Insérer un lien
insertPage=Insérer une page
insertRectangle=Insérer un rectangle
insertRhombus=Insert Rhombus
insertRowBefore=Insérer une ligne avant
insertRowAfter=Insérer une ligne après
insertText=Insérer du texte
inserting=Insertion
invalidFilename=Le nom des diagrammes ne doit pas contenir les caractères suivants : \ / | : ; { } < > & + ? = "
invalidLicenseSeeThisPage=Votre licence n'est pas valide, veuillez vous rendre sur la page suivante <a target="_blank" href="https://support.draw.io/display/DFCS/Licensing+your+draw.io+plugin">page</a>.
invalidName=Nom invalide
invalidOrMissingFile=Fichier invalide ou manquant
invalidPublicUrl=URL public invalide
isometric=Isométrique
ios=iOS
italic=Italique
kennedy=Kennedy
keyboardShortcuts=Raccourcis clavier
layers=Couches
landscape=Paysage
language=Langue
leanMapping=Configuration de l'inclinaison
lastChange=Dernière modification il y a {1}
lessThanAMinute=moins d'une minute
licensingError=Erreur de licence
licenseHasExpired=La license pour {1} a expiré le {2}. Cliquez ici.
licenseWillExpire=La license pour {1} expirera le {2}. Cliquez ici.
lineJumps=Line jumps
linkAccountRequired=Si le diagramme n'est pas public, un compte Google est requis pour voir le lien.
linkText=Texte du lien
list=Liste
minute=minute
minutes=minutes
hours=heures
days=jours
months=mois
years=années
restartForChangeRequired=Les modifications seront effectives après un rechargement de la page.
laneColor=Couleur de rangée
lastModified=Dernière modification
layout=Modèle
left=Gauche
leftAlign=Aligner à gauche
leftToRight=De gauche à droite
libraryTooltip=Glissez-déposez les formes ici ou cliquez sur + pour insérer. Double-cliquez pour modifier.
lightbox=Table lumineuse
line=Ligne
lineend=Fin de la ligne
lineheight=Hauteur de ligne
linestart=Début de la ligne
linewidth=Largeur de la ligne
link=Lien
links=Liens
loading=Chargement
lockUnlock=Bloquer/Débloquer
loggedOut=Se déconnecter
logIn=Se connecter
loveIt=J'aime {1}
lucidchart=Lucidchart
maps=Maps
mathematicalTypesetting=Paramètres d'entrée mathématique
makeCopy=Faire une copie
manual=Manuel
middle=Au milieu
minimal=Minimal
misc=Divers
mockups=Maquettes
modificationDate=Date de modification
modifiedBy=Modifié par
more=Plus
moreResults=Plus de résultats
moreShapes=Plus d'icones
move=Deplacer
moveToFolder=Deplacer vers le répertoire
moving=En cours de déplacement
moveSelectionTo=Déplacer la sélection vers {1}
name=Nom
navigation=Navigation
network=Network
networking=Réseautage
new=Nouveau
newLibrary=Nouvelle librairie
nextPage=Page suivante
noAttachments=Aucune pièce jointe n'a éte trouvée
noColor=Pas de couleur
noFiles=Pas de fichiers
noFileSelected=Aucun fichier sélectionné
noLibraries=Aucune librairie trouvée
noMoreResults=Pas d'autres résultats trouvés
none=Aucun
noOtherViewers=Pas d'autres spectateurs
noPlugins=Pas de plug-ins
noPreview=Pas d'aperçu
noResponse=Pas de réponse du serveur
noResultsFor=Pas de résultats pour '{1}'
noRevisions=Pas de révisions
noSearchResults=Aucun résultat de recherche trouvé
noPageContentOrNotSaved=Aucune ancre n'a été trouvée sur cette page ou aucune ancre n'a été enregistrée pour le moment 
normal=Normal
north=Nord
notADiagramFile=N'est pas un fichier de diagramme
notALibraryFile=N'est pas un fichier de librairie
notAvailable=N'est pas disponible
notAUtf8File=N'est pas un fichier UTF-8
notConnected=Non connecté
note=Remarque
notUsingService=Pas en train d'utiliser {1}?
numberedList=Liste numérotée
offline=Hors ligne
ok=OK
oneDrive=OneDrive
online=En ligne
opacity=Opacité
open=Ouvrir
openArrow=Ouvrir la flèche
openExistingDiagram=Ouvrir un diagramme existant
openFile=Ouvrir le fichier
openFrom=Ouvrir depuis
openLibrary=Ouvrir une librairie
openLibraryFrom=Ouvrir une librairie depuis
openLink=Ouvrir le lien
openInNewWindow=Ouvrir dans une nouvelle fenêtre
openInThisWindow=Ouvrir dans cette fenêtre
openIt=Ouvrir {1}
openRecent=Ouvrir récent
openSupported=Les formats supportés sont les fichiers sauvegardés depuis ce logiciel (.xml), .vsdx et .gliffy
options=Options
organic=Organique
orthogonal=Orthogonale
otherViewer=autre lecteur
otherViewers=autres lecteurs
outline=Contour
oval=Ovale
page=Page
pageContent=Contenu de la page
pageNotFound=Page non trouvée
pageWithNumber=Page-{1}
pages=Pages
pageView=Aperçu de la page
pageSetup=Paramètres de la page
pageScale=Échelle de la page
pan=Panoramique
panTooltip=Espace+Glisser pour déplacer
paperSize=Taille du papier
pattern=Modèle
paste=Coller
pasteHere=Coller ici
pasteSize=Paste Size
pasteStyle=Coller le style
perimeter=Périmètre
permissionAnyone=Tout le monde peut apporter des modifications
permissionAuthor=Moi seul peux apporter des modifications
pickFolder=Choisir un dossier
pickLibraryDialogTitle=Sélectionner une librairie
publicDiagramUrl=URL publique du diagramme
placeholders=Eléments de remplissage
plantUml=PlantUML
plugins=Modules complémentaires
pluginUrl=URL du module complémentaire
pluginWarning=La page demande le chargement de(s) module(s) suivant(s):\n \n {1}\n \n Voulez-vous le(s) charger maintenant?\n \n REMARQUE : N'autorisez l'exécution des modules complémentaires que si vous êtes totalement conscient de l'impact que cette action peut avoir sur la sécurité.\n
plusTooltip=Glisser/Déposer pour lier, cliquer pour cloner et lier, Shift+clic pour cloner
portrait=Portrait
position=Position
posterPrint=Données de l’impression
preferences=Préférences
preview=Aperçu
previousPage=Page précédente
print=Imprimer
printAllPages=Imprimer toutes les pages
procEng=Ing. Proc.
project=Projet
priority=Priorité
properties=Propriétés
publish=Publier
quickStart=Vidéo de démarrage rapide
rack=Etagère
radialTree=Arbre radial
readOnly=Lecture seule
reconnecting=Reconnexion
recentlyUpdated=Récemment mis(e) à jour
recentlyViewed=Récemment visionné(e)
rectangle=Rectangle
redirectToNewApp=Ce fichier a été créé ou modifié dans une version plus récente de cette application. Vous allez être redirigé(e) maintenant.
realtimeTimeout=Il semble que des modifications hors ligne ont été effectuées. Nous sommes désolés, ces modifications ne peuvent être enregistrées.
redo=Refaire
refresh=Rafraichir
regularExpression=Expression régulière
relativeUrlNotAllowed=Relative URL not allowed
rememberMe=Se souvenir de moi
rememberThisSetting=Se rappeler de ce paramètre
removeFormat=Effacer la mise en forme
removeFromGroup=Retirer du groupe
removeIt=Retirer {1}
removeWaypoint=Effacer le repère
rename=Renommer
renamed=Renommé
renameIt=Renommer {1}
renaming=Renommage
replace=Remplacer
replaceIt={1} existe déjà. Voulez-vous le remplacer?
replaceExistingDrawing=Remplacer le diagramme existant
required=obligatoire
reset=Réinitialiser
resetView=Réinitialiser la vue
resize=Redimensionner
resizeLargeImages=Do you want to resize large images to make the application run faster?
retina=Rétine
responsive=Adapte
restore=Récupérer
restoring=Récupération
retryingIn=Nouvelle tentative dans {1} seconde(s)
retryingLoad=Le chargement a échoué. Nouvel essai...
retryingLogin=L'identification a échoué. Nouvel essai...
reverse=Inverser
revision=Changement
revisionHistory=Historique des changement
rhombus=Rhombus
right=Droite
rightAlign=Aligner à droite
rightToLeft=Droite à Gauche
rotate=Pivoter
rotateTooltip=Cliquer et glisser pour pivoter, cliquer pour pivoter de 90 degrés
rotation=Rotation
rounded=Arrondi
save=Enregistrer
saveAndExit=Enregistrer et quitter
saveAs=Enregistrer sous
saveAsXmlFile=Enregistrer sous un fichier XML?
saved=Enregistré
saveDiagramsTo=Enregistrer sous
saveLibrary403=Permissions insuffisantes pour modifier cette librairie
saveLibrary500=Une erreur est survenue lors de la sauvegarde de la librairie
saving=Enregistrement
scratchpad=Bloc-notes
scrollbars=Barres de défilement
search=Chercher
searchShapes=Chercher des formes
selectAll=Tout sélectionner
selectionOnly=Sélection uniquement
selectCard=Select Card
selectEdges=Selectionner les bordures
selectFile=Sélectionner le fichier
selectFolder=Sélectionner le dossier
selectFont=Sélectionner une police
selectNone=Tout désélectionner
selectTemplate=Select Template
selectVertices=Sélectionner des sommets
sendMessage=Envoyer
sendYourFeedbackToDrawIo=Envoyer votre commentaire à draw.io
serviceUnavailableOrBlocked=Le service est indisponible ou bloqué
sessionExpired=Votre session a expiré. Merci de rafraichir la page.
sessionTimeoutOnSave=Votre session a expiré et vous avez été déconnecté de Google Drive. Cliquer sur OK pour vous identifier et enregistrer votre travail.
setAsDefaultStyle=Définir comme style par défaut
shadow=Ombre
shape=Forme
shapes=Formes
share=Partager
shareLink=Lien pour l'édition partagée
sharp=Dur
show=Afficher
showStartScreen=Montrer écran de démarrage
sidebarTooltip=Cliquer pour agrandir. Glisser et déposer les formes sur le diagramme. Maj+clic pour changer la sélection. Alt+clic pour insérer et connecter.
signs=Signes
signOut=Se déconnecter
simple=Simple
simpleArrow=Flèche simple
size=Taille
solid=Uni
sourceSpacing=Espacement de la source
south=Sud
software=Logiciel
space=Espace
spacing=Espacement
specialLink=Lien Spécial
standard=Standard
starting=Démarrage
straight=Droit
strokeColor=Couleur de la ligne
style=Style
subscript=Texte miniaturisé
summary=Sommaire
superscript=Texte agrandi
support=Support
sysml=SysML
tags=Tags
table=Tableau
tables=Tables
takeOver=Take Over
targetSpacing=Espacement de la cible
template=Modèle
templates=Modèles
text=Texte
textAlignment=Justifier le texte
textOpacity=Opacité du texte
theme=Thème
timeout=Délai dépassé
title=Titre
to=à
toBack=Placer en dessous
toFront=Placer au-dessus
tooltips=Bulle d'information
top=En haut
topAlign=Aligner en haut
topLeft=Aligner en haut à gauche
topRight=Aligner en haut à droite
transparent=Transparent
transparentBackground=Arrière-plan transparent
trello=Trello
tryAgain=Réessayer
tryOpeningViaThisPage=Essayer d'ouvrir via cette page.
turn=Pivoter à 90°
type=Type
twitter=Twitter
uml=UML
underline=Souligner
undo=Annuler
ungroup=Dissocier
unsavedChanges=Modifications non enregistrées
unsavedChangesClickHereToSave=Modifications non enregistrées. Cliquez ici pour enregistrer.
untitled=Sans nom
untitledDiagram=Diagramme sans nom
untitledLayer=Couche non nommée
untitledLibrary=Librairie sans nom
unknownError=Erreur inconnue
updateFile=Mettre à jour {1}
updatingDocument=Mise à jour du document. Veuillez patienter...
updatingPreview=Mise à jour de l'aperçu. Veuillez patienter...
updatingSelection=Mise à jour de la sélection. Veuillez patienter...
upload=Télécharger
url=URL
useRootFolder=Use root folder?
userManual=Manuel d'utilisation
vertical=Vertical
verticalFlow=Flux vertical
verticalTree=Arbre vertical
view=Vue
viewUrl=Lien vers l'aperçu: {1}
voiceAssistant=Assistant vocal (beta)
warning=Avertissement
waypoints=Repères
west=Ouest
width=Largeur
wiki=Wiki
wordWrap=Retour à la ligne
writingDirection=Sens de l'écriture
yourEmailAddress=Votre adresse email
zoom=Zoom
zoomIn=Agrandir
zoomOut=Réduire
basic=Essentiel
businessprocess=Processus Métier
charts=Graphiques
engineering=Ingénierie
flowcharts=Organigrammes
gmdl=Conception du matériau
mindmaps=Cartes cognitives
mockups=Maquettes
networkdiagrams=Diagrammes réseau
nothingIsSelected=Pas de sélection
other=Autre
softwaredesign=Modélisation logicielle
venndiagrams=Diagrammes de Venn
webEmailOrOther=Site, email ou toute autre adresse internet
webLink=Hyperlien
wireframes=Maquettes conceptuelles
